NO ./dfter.png
SO ./dfter.png
WE ./dfter.png
EA ./dfter.png
F  220, 125, 200

C 225,30,0             

111111111111111111111111111    
111101111111111111100001111              
111100111111101010011001111
11001001011111000000010N011
100000000000000110000001011
100000000000000011010100111           
111111111111111111111111111
