NO ./dfter.png
SO ./dfter.png
WE ./dfter.png
EA ./dfter.png
F  220, 125, 200

C 225,30,0             

11111111111111111111111111
10000000000000000000000001
10000000000011111000000001
10000000000000000000000001
1000000100000N010000000001
10000000000000100000000001
10000000000000000000000001
10000000000000000000000001
11111111111111111111111111
