NO ./dfter.png
SO ./dfter.png
WE ./dfter.png
EA ./dfter.png
F  220, 125, 200

C 225,30,0             

1111111111111111111111
1000000000000000000001
1000000011111000000001
1000000000010001000001
10010000001N0000100001
100000000010000000001
1000000000000000000001
1000000000000000000001
1111111111111111111111
