NO ./dfter.png
SO ./dfter.png
WE ./dfter.png
EA ./dfter.png
F  220, 125  , 200

C 225,30,0             

1111111111111111111111
1110000000000000000001
100000001111000000001
100000N00000000000001
100100000100100100001
100000000001010000001
1000000000000000000001
1000000000000000000001
1111111111111111111111
