NO ./dfter.png
SO ./dfter.png
WE ./dfter.png
EA ./dfter.png
F  220, 125  , 200

C 225,30,0             

11111111111111111111111111111111111111
1110N00000000000000000000000000000000011111
1000000011110000000000000000000000000000001
1000000000000000000000000000000000000000001
1001000001001001000000000000000000000000001
1001000001001001000000000000000000000000001
1001000001001001000000000000000000000000001
1001000001001001000000000000000000000000001
1001000001001001000000000000000000000000001
1001000001001001000000000000000000000000001
1001000001001001000000000000000000000000001
1001000001001001000000000000000000000000001
1001000001001001000000000000000000000000001
1001000001001001000000000000000000000000001
1001000001001001000000000000000000000000001
1001000001001001000000000000000000000000001
1001000001001001000000000000000000000000001
1001000001001001000000000000000000000000001
1001000001001001000000000000000000000000001
1001000001001001000000000000000000000000001
1001000001001001000000000000000000000000001
1001000001001001000000000000000000000000001
1001000001001001000000000000000000000000001
1001000001001001000000000000000000000000001
1001000001001001000000000000000000000000001
1001000001001001000000000000000000000000001
1001000001001001000000000000000000000000001
1000000000010100000000000000000000000000001
10000000000000000000000000000000000000000001
10000000000000000000000000000000000000000001
11111111111111111111111111111111111111111111
