D ./door.png


NO ./berlin.png
SO ./berlin.png
WE ./berlin.png
EA ./berlin.png

F  25, 25, 112
C 225   ,  30  ,0     


111111111111111111111111111111
100000001110000001110000000001
1000000011111D1000000000000001
100000001110000000000000000001
100000001110000000000000000001
10000000111111N111110000001001
10000000111111D111110000010001
100000001110000000000000000001
100000001110000000000000000001
100000001110000001110000000001
10000000111000000110000000001
100000001110000001110000000001
100000001110000001110000000001
111111111111111111111111111111
