NO ./dfter.png
SO ./dfter.png
WE ./dfter.png
EA ./dfter.png
F  220, 125, 200

C 225,30,0             

111111111111111111111111111    
111101111111111111100001111              
111100111111101010011001111
110010010110110000000100011
100000000001000110000000011
10000000001000001101010N011           
1111111111111111111111111
