D ./textures/door.png
NO ./textures/berlin.png
SO ./textures/berlin.png
WE ./textures/berlin.png
EA ./textures/berlin.png


F 80, 80, 80
C     25, 25, 112

111111111111111111111111111
1000N0000011000000000111111
1000D00000000000000111111
1000D000001000000000111111
1000D000001000000000111111
1000D000000000000000111111
111111111111111111111111111


