D ./textures/door.png
NO ./textures/berlin.png
SO ./textures/berlin.png
WE ./textures/berlin.png
EA ./textures/berlin.png


F 80, 80, 80
C     25, 25, 112

11111111111
   1N1
   1D1
11111111111


