NO ./textures/berlin.png
SO ./textures/berlin.png
WE ./textures/berlin.png
EA ./textures/berlin.png


F 80, 80, 80
C     25, 25, 112


1111111111111111111111111111111111111111111
1N00000000000000000000000000000000000000001
1011111111111111111111111111111111111011101
1010000000000000000000000000000000000000101
1010111111111111111111111111111111111110101
1010100000000000000000000000000000000000101
1010101111111111111111111111111111111110101
1010101000000000000000000000000000000000101
1010101011111111111111111111111111111110101
1010101010000000000000000000000000000000101
1010101010111111111111111111111111111110101
1010101010100000000000000000000000000000101
1010101010101111111111111111111111111110101
1010101010101000000000000000000000000000101
1010101010101011111111111111111111111110101
1010101010101010000000000000000000000000101
1010101010101010111111111111111111111110101
1010101010101010100000000000000000000000101
1010101010101010101111111111111111111110101
1010101010101010101000000000000000000000101
1010101010101010101011111111111111111110101
1010101010101010101010000000000000000000101
1010101010101010101010111111111111111110101
1010101010101010101010100000000000000000101
1000000000000000000000000000000000000000001
1111111111111111111111111111111111111111111
