NO ./textures/berlin.png
SO ./textures/berlin.png
WE ./textures/berlin.png
EA ./textures/berlin.png





F 170,170,170
C 225,30,0           

11111111111111111111111111111111111111111111
  111110000000000000000000000000000000000011111
110000000011110000000000000000000000000000001
 100S000000000000000000000000000000000000001111
1001000001001001000000000000000000000000001
1001000001001001000000000000000000000000001
1001000001001001000000000000000000000000001
1001000001001001000000000000000000000000001
1001000001001001000000000000000000000000001
1001000001001001000000000000000000000000001
1001000001001001000000000000000000000000001
1001000001001001000000000000000000000000001
1001000001001001000000000000000000000000001
1001000001001001000000000000000000000000001
1001000001001001000000000000000000000000001
1001000001001001000000000000000000000000001
1001000001001001000000000000000000000000001
1001000001001001000000000000000000000000001
 1001000001001001000000000000000000000000001
1001000001001001000000000000000000000000001
1001000001001001000000000000000000000000001
1001000001001001000000000000000000000000001
1001000001001001000000000000000000000000001
1001000001001001000000000000000000000000001
1001000001001001000000000000000000000000001
1001000001001001000000000000000000000000001
1000000000010100000000000000000000000000001
10000000000000000000000000000000000000000001
10000000000000000000000000000000000000000001
11111111111111111111111111111111111111111111
