D ./textures/door.png
NO ./textures/berlin.png
SO ./textures/berlin.png
WE ./textures/berlin.png
EA ./textures/berlin.png


F 25,5,255
C     00000000000  , 00000     , 255

11111111111111111111111111111
100000001110000001110000000001
1000000011111D1000000000000001
100000001110000000000000000001
1000000011100000N0000000000011
1000000001111110111110000001001
10000000111111D111110000010001
10000000111000000000000000001
10000000111000000000000000001
100000001110000001110000000001
1000000011100D0000110000000001
100000001110000001110000000001
100000001110000001110000000001
1111111111111111111111111111111