D ./textures/door.png


NO ./textures/berlin.png
SO ./textures/berlin.png
WE ./textures/berlin.png
EA ./textures/berlin.png

F  220,125,200
C 225   ,  30  ,0     


111111111111111111111111111111
100000001110000001110000000001
1000000011111D1000000000000001
100000001110000000000000000001
100000001110000000000000000001
100000001111110111110000001001
10000000111111D111110000010001
100000001110000000000000000001
100000001110000000000000000001
100000001110000001110000000001
10000000111000000110000000001
10000000111000N001110000000001
100000001110000001110000000001
111111111111111111111111111111
